BBBBBBBBBBBBBBBBBBBBBBBBBBBBBBBBBBBBBBBBBBBBBBBBBBBBBBBBBBBBBBBB
B--------------------------------------------------------------B
B--------------------------------------------------------------B
B-------------------------G------------------------------------B
B--------------P---------------BBBBBBBBBBBBBBBBBBBBBBBBBBBBBBBBB
B------------------------------BBBBBBBBBBBBBBBBBBBBBBBBBBBBBBBBB
B-B--B--B--B--B--B---B---------B--------------------------------
BBBBBBBBBBBBBBBBBBBBBBBBBBBBBBBBBBBBBBBBBBBBBBBBBBBBBBBBBBBBBBBB
BBBBBBBBBBBBBBBBBBBBBBBBB--BBBBBBBBBBBBBBBBBBBBBBBBBBBBBBBBBBBBB
BBBBBBBBBBBBBBBBBBBBBBBBBBBBBBBBBBBBBBBBBBBBBBBBBBBBBBBBBBBBBBBB
BBBBBBBBBBBBBB--BBBBBBBBBBBBBBBBBBBBBBBBBBBBBBBBBBBBBBBBBBBBBBBB
BBBBBBBBBBBBBBBBB--BBBBBBBBBBBBBBBBBBBBBBBBBBBBBBBBBBBBBBBBBBBBB
B-B--B--B--B--B--B---B---------B-------------------------------B
B-B--B--B--B--B--B---B---------B-------------------------------B
B-B--B--B--B--B--B---B---------B-------------------------------B
B-B--B--B--B--B--B---B---------B--------------BBBBBBBBBBBBBBBBBB
B-B--B--B--B--B--B---B---------B-------------------------------B
B-B--B--B--B--B--B---B---------B-------------------------------B
B-B--B--B--B--B--B---B---------B-BB----------------------------B
B-B--B--B--B--B--B---B-BBBBBB--B-------------------------------B
B-B--B--B--B--B--B---B---------B-------------------------------B
B-B--B--B--B--B--B---B---------B-------------------------------B
B-B--B--B--B--B--B---B---------B-------------------------------B
B-B--B--B--B--B--B---B-BBBBBB--B-------------------------------B
B-B--B--B--B--B--B---B---------B-------------BBBBBBBBBBBBBB----B
B-B--B--B--B--B--B---B---------B-------------------------------B
B-B--B--B--B--B--B---B---------B-------------------------------B
B-B--B--B--B--B--B---B---------B-----BBBBBBBBBBBBBBBBBBBBBB----B
B-B--B--B--B--B--B---B---------B-------------------------------B
B-B--B--B--B--B--B---B-BBBBBB--B-------------------------------B
B-B--B--B--B--B--B---B---------B-------------------------------B
BBBBBBBBBBBBBBBBBBBBBBBBBBBBBBBBBBBBBBBBBBBBBBBBBBBBBBBBBBBBBBBB