BBBBBBBBBBBBBBBBBBBBBBBBBBBBBBBBBBBBBBBBBBBBBBBBBBBBBBBBBBBBBBBB
B--------------------------------------------------------------B
B-------------------------G------------------------------------B
B--------------------------------------------------------------B
B------------------------------BBBBBBBBBBBBBBBBBBBBBBBBBBBBBBBBB
B------------------------------BBBBBBBBBBBBBBBBBBBBBBBBBBBBBBBBB
B--------------------------------------------------------------B
B--------------------------------------------------------------B
B--------------------------------------------------------------B
B--------------P-----------------------------------------------B
B--------------------------------------------------------------B
BBBBBBBBBBBBBBBBBBBBBBBBBBBBBBBBBBBBBBBBBBBBBBBBBBBBBBBBBBBBBBBB
BBBBBBBBBBBBBBBBBBBBBBBBBBBBBBBBBBBBBBBBBBBBBBBBBBBBBBBBBBBBBBBB
BBBBBBBBBBBBBBBBBBBBBBBBBBBBBBBBBBBBBBBBBBBBBBBBBBBBBBBBBBBBBBBB
BBBBBBBBBBBBBBBBBBBBBBBBBBBBBBBBBBBBBBBBBBBBBBBBBBBBBBBBBBBBBBBB
BBBBBBBBBBBBBBBBBBBBBBBBBBBBBBBBBBBBBBBBBBBBBBBBBBBBBBBBBBBBBBBB
BBBBBBBBBBBBBBBBBBBBBBBBBBBBBBBBBBBBBBBBBBBBBBBBBBBBBBBBBBBBBBBB
BBBBBBBBBBBBBBBBBBBBBBBBBBBBBBBBBBBBBBBBBBBBBBBBBBBBBBBBBBBBBBBB
BBBBBBBBBBBBBBBBBBBBBBBBBBBBBBBBBBBBBBBBBBBBBBBBBBBBBBBBBBBBBBBB
BBBBBBBBBBBBBBBBBBBBBBBBBBBBBBBBBBBBBBBBBBBBBBBBBBBBBBBBBBBBBBBB
B-B--B--B--B--B--B---B---------B-------------------------------B
B-B--B--B--BB-B--B---B---------B------BBBBBBB------------------B
B-BBBBBBB--B--B--B---B--BBBB---B-------------------------------B
BBB--B--B--B--B--B---B---------B--BBBB--------BBBBBBBBBBBBBBBBBB
BBB--B--B--B--BB-B---BBBB-BB---B-------------------------------B
B-B--B--B--BB-B--B---B---------B-------------------------------B
BBB--B--B--B--B--B---B-BBBBBB--B-------------------------------B
BBB--B--B--B--B--B---B---------B-------------BBBBBBBBBBBBBB----B
B-B--B--B--B--B--B---B---------B--------------------G----------B
B-B--B--B--B--B--B---B---------B-------------------------------B
B-B--B--B--B--B--B---B---------B-----BBBBBBBBBBBBBBBBBBBBBB----B
BBBBBBBBBBBBBBBBBBBBBBBBBBBBBBBBBBBBBBBBBBBBBBBBBBBBBBBBBBBBBBBB