BBBBBBBBBBBBBBBBBBBBBBBBBBBBBBBB
B------------------------------B
B------------------------------B
B------------------------------B
B------------------------------B
B--------------P---------------B
B------------------------------B
B-B--B--B--B--B--B---B---------B
BBBBBBBBBBBBBBBBBBBBBBBBBBBBBBBB
B------------------------------B
B----------------B-------------B
B------------B------B----------B
B----------B------------B------B
B--------------p--------B------B
B-----B-----------------B------B
BBBBBBBBBBBBBBBBBBBBBBBBBBBBBBBB